************
*          *
*  ppppp   * 
*          *
*  cccc    *
*       s  *
* tt    s  *
*       s  *
*          * 
*  sss     *
*          *
************