************
*s    p   c*
*s    p   c* 
*s    p   c*
*     p   c*
*  t  p    *
*  t       *
*         s*
*         s* 
*         s*
*          *
************