************
*          *
*   cccc   * 
*          *
*  p       *
*  p    s  *
*  p    s  *
*  p    s  *
*  p       * 
*       tt *
*   sss    *
************