************
*  cccc    *
*          * 
*  sss     *
*          *
*  tt      *
*          *
*  sss     *
*          * 
*          *
* ppppp    *
************