************
*          *
*          * 
*          *
*  cccc    *
*        s *
*        s *
*        s *
*  ppppp   * 
*          *
*  sss   tt*
************