************
*cccc      *
*          * 
*p        s*
*p        s*
*p        s*
*p         *
*p         *
*         t* 
*         t*
*   sss    *
************