************
*sss sss   *
*          * 
*          *
*  cccc tt *
*          *
*    p     *
*    p     *
*    p     * 
*    p     *
*    p     *
************