************
*      cccc*
*          * 
*     ppppp*
*          *
*       sss*
*          *
*        tt*
*          * 
*          *
*       sss*
************