************
*s    p   c*
*s    p   c* 
*s    p   c*
*     p   c*
*     p    *
*          *
*t         *
*t         * 
*          *
*       sss*
************